{
  "playerStart": {
    "x": 34,
    "y": 138
  },

  "ballSpeed": {
    "value": 32
  },

  "taggedTiles": [],

  "tiles": [
      [9, 6, 6, 6, 6, 6, 6, 6, 6, 6, 6, 6, 6, 6, 6, 6, 6, 6, 6, 6, 6, 6, 6, 6, 6, 6, 6, 6, 6, 6, 6, 6, 6, 6, 6, 6, 6, 6, 6, 9],
      [4, 0, 0, 0, 0, 0, 0, 0, 0, 0, 0, 0, 0, 0, 0, 0, 0, 0, 0, 0, 0, 0, 0, 0, 0, 0, 0, 0, 0, 0, 0, 0, 0, 0, 0, 0, 0, 0, 0, 8],
      [4, 0, 0, 0, 0, 0, 0, 0, 0, 0, 0, 0, 0, 0, 0, 0, 0, 0, 0, 0, 0, 0, 0, 0, 0, 0, 0, 0, 0, 0, 0, 0, 0, 0, 0, 0, 0, 0, 0, 8],
      [4, 0, 0, 0, 0, 0, 0, 0, 0, 0, 0, 0, 0, 0, 0, 0, 0, 0, 0, 0, 0, 0, 0, 0, 0, 0, 0, 0, 0, 0, 0, 0, 0, 0, 0, 0, 0, 0, 0, 8],
      [4, 0, 0, 0, 0, 0, 1, 2, 3, 0, 0, 1, 3, 0, 0, 0, 0, 1, 2, 2, 3, 0, 0, 0, 1, 2, 3, 0, 0, 0, 1, 2, 2, 3, 0, 0, 0, 0, 0, 8],
      [4, 0, 0, 0, 0, 1, 9, 6, 5, 0, 0, 8, 4, 0, 0, 0, 0, 8, 9, 6, 5, 0, 0, 1, 9, 6, 9, 3, 0, 0, 8, 9, 6, 9, 3, 0, 0, 0, 0, 8],
      [4, 0, 0, 0, 0, 8, 4, 0, 0, 0, 0, 8, 4, 0, 0, 0, 0, 8, 4, 0, 0, 0, 0, 8, 4, 0, 8, 4, 0, 0, 8, 4, 0, 8, 4, 0, 0, 0, 0, 8],
      [4, 0, 0, 0, 0, 8, 4, 0, 0, 0, 0, 8, 4, 0, 0, 0, 0, 8, 9, 2, 3, 0, 0, 8, 4, 0, 8, 4, 0, 0, 8, 4, 0, 8, 5, 0, 0, 0, 0, 8],
      [4, 0, 0, 0, 0, 8, 4, 0, 0, 0, 0, 8, 4, 0, 0, 0, 0, 8, 9, 6, 5, 0, 0, 8, 9, 2, 9, 4, 0, 0, 8, 9, 2, 4, 0, 0, 0, 0, 0, 8],
      [4, 0, 0, 0, 0, 8, 4, 0, 0, 0, 0, 8, 4, 0, 0, 0, 0, 8, 4, 0, 0, 0, 0, 8, 9, 6, 9, 4, 0, 0, 8, 9, 6, 9, 3, 0, 0, 0, 0, 8],
      [4, 0, 0, 0, 0, 7, 9, 2, 3, 0, 0, 8, 9, 2, 3, 0, 0, 8, 9, 2, 3, 0, 0, 8, 4, 0, 8, 4, 0, 0, 8, 4, 0, 8, 4, 0, 0, 0, 0, 8],
      [4, 0, 0, 0, 0, 0, 7, 6, 5, 0, 0, 7, 6, 6, 5, 0, 0, 7, 6, 6, 5, 0, 0, 7, 5, 0, 7, 5, 0, 0, 7, 5, 0, 7, 5, 0, 0, 0, 0, 8],
      [4, 0, 0, 0, 0, 0, 0, 0, 0, 0, 0, 0, 0, 0, 0, 0, 0, 0, 0, 0, 0, 0, 0, 0, 0, 0, 0, 0, 0, 0, 0, 0, 0, 0, 0, 0, 0, 0, 0, 8],
      [4, 0, 0, 0, 0, 0, 0, 0, 0, 0, 0, 0, 0, 0, 0, 0, 0, 0, 0, 0, 0, 0, 0, 0, 0, 0, 0, 0, 0, 0, 0, 0, 0, 0, 0, 0, 0, 0, 0, 8],
      [4, 0, 0, 0, 0, 0, 0, 0, 0, 0, 0, 0, 0, 0, 0, 0, 0, 0, 0, 0, 0, 0, 0, 0, 0, 0, 0, 0, 0, 0, 0, 0, 0, 0, 0, 0, 0, 0, 0, 8],
      [4, 0, 0, 0, 0, 0, 0, 0, 0, 0, 0, 0, 0, 0, 0, 0, 0, 0, 0, 0, 0, 0, 0, 0, 0, 0, 0, 0, 0, 0, 0, 0, 0, 0, 0, 0, 0, 0, 0, 8],
      [4, 0, 0, 0, 0, 0, 0, 0, 0, 0, 0, 0, 0, 0, 0, 0, 0, 0, 0, 0, 0, 0, 0, 0, 0, 0, 0, 0, 0, 0, 0, 0, 0, 0, 0, 0, 0, 0, 0, 8],
      [4, 0, 0, 0, 0, 0, 0, 0, 0, 0, 0, 0, 0, 0, 0, 0, 0, 0, 0, 0, 0, 0, 0, 0, 0, 0, 0, 0, 0, 0, 0, 0, 0, 0, 0, 0, 0, 0, 0, 8],
      [4, 0, 0, 0, 0, 0, 0, 0, 0, 0, 0, 0, 0, 0, 0, 0, 0, 0, 0, 0, 0, 0, 0, 0, 0, 0, 0, 0, 0, 0, 0, 0, 0, 0, 0, 0, 0, 0, 0, 8],
      [9, 2, 2, 2, 2, 2, 2, 2, 2, 2, 2, 2, 2, 2, 2, 2, 2, 2, 2, 2, 2, 2, 2, 2, 2, 2, 2, 2, 2, 2, 2, 2, 2, 2, 2, 2, 2, 2, 2, 9],
      [9, 9, 9, 9, 9, 9, 9, 9, 9, 9, 9, 9, 9, 9, 9, 9, 9, 9, 9, 9, 9, 9, 9, 9, 9, 9, 9, 9, 9, 9, 9, 9, 9, 9, 9, 9, 9, 9, 9, 9],
      [9, 9, 9, 9, 9, 9, 9, 9, 9, 9, 9, 9, 9, 9, 9, 9, 9, 9, 9, 9, 9, 9, 9, 9, 9, 9, 9, 9, 9, 9, 9, 9, 9, 9, 9, 9, 9, 9, 9, 9],
      [9, 9, 9, 9, 9, 9, 9, 9, 9, 9, 9, 9, 9, 9, 9, 9, 9, 9, 9, 9, 9, 9, 9, 9, 9, 9, 9, 9, 9, 9, 9, 9, 9, 9, 9, 9, 9, 9, 9, 9],
      [9, 9, 9, 9, 9, 9, 9, 9, 9, 9, 9, 9, 9, 9, 9, 9, 9, 9, 9, 9, 9, 9, 9, 9, 9, 9, 9, 9, 9, 9, 9, 9, 9, 9, 9, 9, 9, 9, 9, 9]
    ]
}