{
  "playerStart": {
    "x": 17,
    "y": 161
  },

  "ballSpeed": {
    "value": 32
  },

  "taggedTiles": [
    {
      "x": 4,
      "y": 21,
      "tag": "A",
      "type": "PlayerSwitch"
    },
    {
      "x": 1,
      "y": 12,
      "tag": "A",
      "type": "BallGenerator"
    },
    {
      "x": 38,
      "y": 12,
      "tag": "A",
      "type": "BallGenerator"
    },
    {
      "x": 16,
      "y": 21,
      "tag": "B",
      "type": "PlayerSwitch"
    },
    {
      "x": 12,
      "y": 1,
      "tag": "B",
      "type": "Toggle"
    },
    {
      "x": 12,
      "y": 2,
      "tag": "B",
      "type": "Toggle"
    },
    {
      "x": 12,
      "y": 3,
      "tag": "B",
      "type": "Toggle"
    },
    {
      "x": 12,
      "y": 4,
      "tag": "B",
      "type": "Toggle"
    },
    {
      "x": 12,
      "y": 5,
      "tag": "B",
      "type": "Toggle"
    },
    {
      "x": 3,
      "y": 7,
      "tag": "B",
      "type": "Toggle"
    },
    {
      "x": 4,
      "y": 7,
      "tag": "B",
      "type": "Toggle"
    },
    {
      "x": 5,
      "y": 7,
      "tag": "B",
      "type": "Toggle"
    },
    {
      "x": 22,
      "y": 21,
      "tag": "C",
      "type": "PlayerSwitch"
    },
    {
      "x": 27,
      "y": 1,
      "tag": "C",
      "type": "Toggle"
    },
    {
      "x": 27,
      "y": 2,
      "tag": "C",
      "type": "Toggle"
    },
    {
      "x": 27,
      "y": 3,
      "tag": "C",
      "type": "Toggle"
    },
    {
      "x": 27,
      "y": 4,
      "tag": "C",
      "type": "Toggle"
    },
    {
      "x": 27,
      "y": 5,
      "tag": "C",
      "type": "Toggle"
    },
    {
      "x": 34,
      "y": 7,
      "tag": "C",
      "type": "Toggle"
    },
    {
      "x": 35,
      "y": 7,
      "tag": "C",
      "type": "Toggle"
    },
    {
      "x": 36,
      "y": 7,
      "tag": "C",
      "type": "Toggle"
    },
    {
      "x": 0,
      "y": 10,
      "tag": "D",
      "type": "BallSwitch"
    },
    {
      "x": 31,
      "y": 15,
      "tag": "D",
      "type": "Toggle"
    },
    {
      "x": 39,
      "y": 10,
      "tag": "E",
      "type": "BallSwitch"
    },
    {
      "x": 35,
      "y": 15,
      "tag": "E",
      "type": "Toggle"
    }
  ],

  "tiles": [
      [9, 6, 6, 6, 6, 6, 6, 6, 6, 6, 6, 6, 6, 6, 6, 6, 6, 6, 6, 9, 9, 6, 6, 6, 6, 6, 6, 6, 6, 6, 6, 6, 6, 6, 6, 6, 6, 6, 6, 9],
      [4, 0, 0, 0, 0, 0, 0, 0, 0, 0, 0, 0, 15, 0, 0, 0, 0, 0, 0, 8, 4, 0, 0, 0, 0, 0, 0, 15, 0, 0, 0, 0, 0, 0, 0, 0, 0, 0, 0, 8],
      [4, 0, 0, 0, 0, 0, 0, 0, 0, 0, 0, 0, 15, 0, 0, 0, 0, 0, 0, 8, 4, 0, 0, 0, 0, 0, 0, 15, 0, 0, 0, 0, 0, 0, 0, 0, 0, 0, 0, 8],
      [4, 0, 0, 0, 0, 0, 0, 0, 0, 0, 0, 0, 15, 0, 0, 0, 0, 0, 0, 8, 4, 0, 0, 0, 0, 0, 0, 15, 0, 0, 0, 0, 0, 0, 0, 0, 0, 0, 0, 8],
      [4, 0, 0, 0, 0, 0, 0, 0, 0, 0, 0, 0, 15, 0, 0, 0, 0, 0, 0, 8, 4, 0, 0, 0, 0, 0, 0, 15, 0, 0, 0, 0, 0, 0, 0, 0, 0, 0, 0, 8],
      [4, 0, 0, 0, 0, 0, 0, 0, 0, 0, 0, 0, 15, 0, 0, 0, 0, 0, 0, 8, 4, 0, 0, 0, 0, 0, 0, 15, 0, 0, 0, 0, 0, 0, 0, 0, 0, 0, 0, 8],
      [4, 0, 0, 0, 0, 0, 0, 0, 0, 0, 0, 0, 0, 0, 0, 0, 0, 0, 0, 8, 4, 0, 0, 0, 0, 0, 0, 0, 0, 0, 0, 0, 0, 0, 0, 0, 0, 0, 0, 8],
      [4, 0, 0, 15, 15, 15, 0, 0, 0, 0, 0, 0, 0, 0, 0, 0, 0, 0, 0, 8, 4, 0, 0, 0, 0, 0, 0, 0, 0, 0, 0, 0, 0, 0, 15, 15, 15, 0, 0, 8],
      [4, 0, 0, 0, 0, 0, 0, 0, 0, 0, 0, 0, 0, 0, 0, 0, 0, 0, 0, 8, 4, 0, 0, 0, 0, 0, 0, 0, 0, 0, 0, 0, 0, 0, 0, 0, 0, 0, 0, 8],
      [4, 0, 0, 0, 0, 0, 0, 0, 0, 0, 0, 0, 0, 0, 0, 0, 0, 0, 0, 8, 4, 0, 0, 0, 0, 0, 0, 0, 0, 0, 0, 0, 0, 0, 0, 0, 0, 0, 0, 8],
      [10, 0, 0, 0, 0, 0, 0, 0, 0, 0, 0, 0, 0, 0, 0, 0, 0, 0, 0, 8, 4, 0, 0, 0, 0, 0, 0, 0, 0, 0, 0, 0, 0, 0, 0, 0, 0, 0, 0, 10],
      [4, 0, 0, 0, 0, 0, 0, 0, 0, 0, 0, 0, 0, 0, 0, 0, 0, 0, 0, 8, 4, 0, 0, 0, 0, 0, 0, 0, 0, 0, 0, 0, 0, 0, 0, 0, 0, 0, 0, 8],
      [4, 25, 0, 0, 0, 0, 0, 0, 0, 0, 0, 0, 0, 0, 0, 0, 0, 0, 0, 8, 4, 0, 0, 0, 0, 0, 0, 0, 0, 0, 0, 0, 0, 0, 0, 0, 0, 0, 29, 8],
      [9, 2, 2, 2, 2, 2, 2, 2, 2, 2, 2, 2, 2, 2, 2, 2, 2, 2, 2, 9, 9, 2, 2, 2, 2, 2, 2, 2, 2, 2, 2, 2, 2, 2, 2, 2, 2, 2, 2, 9],
      [9, 6, 6, 6, 6, 6, 6, 6, 6, 6, 6, 6, 6, 6, 6, 6, 6, 6, 6, 6, 6, 6, 6, 6, 6, 6, 6, 6, 6, 6, 6, 20, 6, 6, 6, 20, 6, 6, 6, 9],
      [4, 0, 0, 0, 0, 0, 0, 0, 0, 0, 0, 0, 0, 0, 0, 0, 0, 0, 0, 0, 0, 0, 0, 0, 0, 0, 0, 0, 0, 0, 0, 15, 0, 0, 0, 15, 0, 0, 0, 8],
      [4, 0, 0, 0, 0, 0, 0, 0, 0, 0, 0, 0, 0, 0, 0, 0, 0, 0, 0, 0, 0, 0, 0, 0, 0, 0, 0, 0, 0, 0, 0, 0, 0, 0, 0, 0, 0, 0, 0, 8],
      [4, 0, 0, 0, 0, 0, 0, 0, 0, 0, 0, 0, 0, 0, 0, 0, 0, 0, 0, 0, 0, 0, 0, 0, 0, 0, 0, 0, 0, 0, 0, 0, 0, 0, 0, 0, 0, 0, 0, 8],
      [4, 0, 0, 0, 0, 0, 0, 0, 0, 0, 0, 0, 0, 0, 0, 0, 0, 0, 0, 0, 0, 0, 0, 0, 0, 0, 0, 0, 0, 0, 0, 0, 0, 0, 0, 0, 0, 16, 0, 8],
      [4, 0, 0, 0, 0, 0, 0, 0, 0, 0, 0, 0, 0, 0, 0, 0, 0, 0, 0, 0, 0, 0, 0, 0, 0, 0, 0, 0, 0, 0, 0, 0, 0, 0, 0, 1, 2, 2, 2, 9],
      [4, 0, 0, 0, 0, 0, 0, 0, 0, 0, 0, 0, 0, 0, 0, 0, 0, 0, 0, 0, 0, 0, 0, 0, 0, 0, 0, 0, 0, 0, 0, 0, 0, 0, 1, 9, 9, 9, 9, 9],
      [4, 0, 0, 0, 12, 0, 0, 0, 0, 0, 0, 0, 0, 0, 0, 0, 12, 0, 0, 0, 0, 0, 12, 0, 0, 0, 0, 0, 0, 0, 0, 0, 0, 1, 9, 9, 9, 9, 9, 9],
      [9, 2, 2, 2, 2, 2, 2, 2, 2, 2, 2, 2, 2, 2, 2, 2, 2, 2, 2, 2, 2, 2, 2, 2, 2, 2, 2, 2, 2, 2, 2, 2, 2, 9, 9, 9, 9, 9, 9, 9],
      [9, 9, 9, 9, 9, 9, 9, 9, 9, 9, 9, 9, 9, 9, 9, 9, 9, 9, 9, 9, 9, 9, 9, 9, 9, 9, 9, 9, 9, 9, 9, 9, 9, 9, 9, 9, 9, 9, 9, 9]
    ]
}