{
  "playerStart": {
    "x": 25,
    "y": 162
  },

  "ballStart": {
    "x": 290,
    "y": 164
  },

  "ballVelocity": {
    "x": 16,
    "y": -16
  },

  "taggedTiles": [
    {
      "x": 3,
      "y": 21,
      "tag": "A",
      "type": "PlayerSwitch"
    },
    {
      "x": 5,
      "y": 21,
      "tag": "B",
      "type": "PlayerSwitch"
    },
    {
      "x": 7,
      "y": 21,
      "tag": "C",
      "type": "PlayerSwitch"
    },
    {
      "x": 9,
      "y": 21,
      "tag": "D",
      "type": "PlayerSwitch"
    },
    {
      "x": 11,
      "y": 21,
      "tag": "E",
      "type": "PlayerSwitch"
    },
    {
      "x": 14,
      "y": 21,
      "tag": "A",
      "type": "BallSwitch"
    },
    {
      "x": 16,
      "y": 21,
      "tag": "B",
      "type": "BallSwitch"
    },
    {
      "x": 18,
      "y": 21,
      "tag": "C",
      "type": "BallSwitch"
    },
    {
      "x": 20,
      "y": 21,
      "tag": "D",
      "type": "BallSwitch"
    },
    {
      "x": 22,
      "y": 21,
      "tag": "E",
      "type": "BallSwitch"
    },
    {
      "x": 25,
      "y": 21,
      "tag": "A",
      "type": "Toggle"
    },
    {
      "x": 27,
      "y": 21,
      "tag": "B",
      "type": "Toggle"
    },
    {
      "x": 29,
      "y": 21,
      "tag": "C",
      "type": "Toggle"
    },
    {
      "x": 31,
      "y": 21,
      "tag": "D",
      "type": "Toggle"
    },
    {
      "x": 33,
      "y": 21,
      "tag": "E",
      "type": "Toggle"
    },
    {
      "x": 3,
      "y": 18,
      "tag": "A",
      "type": "LaserReceiver"
    },
    {
      "x": 5,
      "y": 18,
      "tag": "B",
      "type": "LaserReceiver"
    },
    {
      "x": 7,
      "y": 18,
      "tag": "C",
      "type": "LaserReceiver"
    },
    {
      "x": 9,
      "y": 18,
      "tag": "D",
      "type": "LaserReceiver"
    },
    {
      "x": 11,
      "y": 18,
      "tag": "E",
      "type": "LaserReceiver"
    }
  ],

  "tiles": [
      [9, 9, 9, 9, 9, 9, 9, 9, 9, 9, 9, 9, 9, 9, 9, 9, 9, 9, 9, 9, 9, 9, 9, 9, 9, 9, 9, 9, 9, 9, 9, 9, 9, 9, 9, 9, 9, 9, 9, 9],
      [9, 9, 6, 6, 6, 6, 6, 6, 6, 6, 6, 6, 6, 6, 6, 6, 6, 6, 6, 6, 6, 6, 6, 6, 6, 6, 6, 6, 6, 6, 6, 6, 6, 6, 6, 6, 6, 6, 9, 9],
      [9, 4, 0, 0, 0, 0, 0, 0, 0, 0, 0, 0, 0, 0, 0, 0, 0, 0, 0, 0, 0, 0, 0, 0, 0, 0, 0, 0, 0, 0, 0, 0, 0, 0, 0, 0, 0, 0, 8, 9],
      [9, 4, 0, 1, 0, 2, 0, 3, 0, 4, 0, 5, 0, 6, 0, 7, 0, 8, 0, 9, 0, 0, 0, 0, 0, 0, 0, 0, 0, 0, 0, 0, 0, 0, 0, 0, 0, 0, 8, 9],
      [9, 4, 0, 0, 0, 0, 0, 0, 0, 0, 0, 0, 0, 0, 0, 0, 0, 0, 0, 0, 0, 0, 0, 0, 0, 0, 0, 0, 0, 0, 0, 0, 0, 0, 0, 0, 0, 0, 8, 9],
      [9, 4, 0, 10, 0, 11, 0, 12, 0, 13, 0, 14, 0, 15, 0, 16, 0, 21, 0, 22, 0, 0, 0, 0, 0, 0, 0, 0, 0, 0, 0, 0, 0, 0, 0, 0, 0, 0, 8, 9],
      [9, 4, 0, 0, 0, 0, 0, 0, 0, 0, 0, 0, 0, 0, 0, 0, 0, 0, 0, 0, 0, 0, 0, 0, 0, 0, 0, 0, 0, 0, 0, 0, 0, 0, 0, 0, 0, 0, 8, 9],
      [9, 4, 0, 17, 0, 18, 0, 19, 0, 20, 0, 0, 0, 0, 0, 0, 0, 0, 0, 0, 0, 0, 0, 0, 0, 0, 0, 0, 0, 0, 0, 0, 0, 0, 0, 0, 0, 0, 8, 9],
      [9, 4, 0, 0, 0, 0, 0, 0, 0, 0, 0, 0, 0, 0, 0, 0, 0, 0, 0, 0, 0, 0, 0, 0, 0, 0, 0, 0, 0, 0, 0, 0, 0, 0, 0, 0, 0, 0, 8, 9],
      [9, 4, 0, 0, 0, 0, 0, 0, 0, 0, 0, 0, 0, 0, 0, 0, 0, 0, 0, 0, 0, 0, 0, 0, 0, 0, 0, 0, 0, 0, 0, 0, 0, 0, 0, 0, 0, 0, 8, 9],
      [9, 4, 0, 0, 0, 0, 0, 0, 0, 0, 0, 0, 0, 0, 0, 0, 0, 0, 0, 0, 0, 0, 0, 0, 0, 0, 0, 0, 0, 0, 0, 0, 0, 0, 0, 0, 0, 0, 8, 9],
      [9, 4, 0, 0, 0, 0, 0, 0, 0, 0, 0, 0, 0, 0, 0, 0, 0, 0, 0, 0, 0, 0, 0, 0, 0, 0, 0, 0, 0, 0, 0, 0, 0, 0, 0, 0, 0, 0, 8, 9],
      [9, 4, 0, 0, 0, 0, 0, 0, 0, 0, 0, 0, 0, 0, 0, 0, 0, 0, 0, 0, 0, 0, 0, 0, 0, 0, 0, 0, 0, 0, 0, 0, 0, 0, 0, 0, 0, 0, 8, 9],
      [9, 4, 0, 0, 0, 0, 0, 0, 0, 0, 0, 0, 0, 0, 0, 0, 0, 0, 0, 0, 0, 0, 0, 0, 0, 0, 0, 0, 0, 0, 0, 0, 0, 0, 0, 0, 0, 0, 8, 9],
      [9, 4, 0, 0, 0, 0, 0, 0, 0, 0, 0, 0, 0, 0, 0, 0, 0, 0, 0, 0, 0, 0, 0, 0, 0, 0, 0, 0, 0, 0, 0, 0, 0, 0, 0, 0, 0, 0, 8, 9],
      [9, 4, 0, 0, 0, 0, 0, 0, 0, 0, 0, 0, 0, 0, 0, 0, 0, 0, 0, 0, 0, 0, 0, 0, 0, 0, 0, 0, 0, 0, 0, 0, 0, 0, 0, 0, 0, 0, 8, 9],
      [9, 4, 0, 0, 0, 0, 0, 0, 0, 0, 0, 0, 0, 0, 0, 0, 0, 0, 0, 0, 0, 0, 0, 0, 0, 0, 0, 0, 0, 0, 0, 0, 0, 0, 0, 0, 0, 0, 8, 9],
      [9, 4, 0, 0, 0, 0, 0, 0, 0, 0, 0, 0, 0, 0, 0, 0, 0, 0, 0, 0, 0, 0, 0, 0, 0, 0, 0, 0, 0, 0, 0, 0, 0, 0, 0, 0, 0, 0, 8, 9],
      [9, 4, 0, 21, 0, 21, 0, 21, 0, 21, 0, 21, 0, 0, 0, 0, 0, 0, 0, 0, 0, 0, 0, 0, 0, 0, 0, 0, 0, 0, 0, 0, 0, 0, 0, 0, 0, 0, 8, 9],
      [9, 4, 0, 0, 0, 0, 0, 0, 0, 0, 0, 0, 0, 0, 0, 0, 0, 0, 0, 0, 0, 0, 0, 0, 0, 0, 0, 0, 0, 0, 0, 0, 0, 0, 0, 0, 0, 0, 8, 9],
      [9, 4, 0, 0, 0, 0, 0, 0, 0, 0, 0, 0, 0, 0, 0, 0, 0, 0, 0, 0, 0, 0, 0, 0, 0, 0, 0, 0, 0, 0, 0, 0, 0, 0, 0, 0, 0, 0, 8, 9],
      [9, 4, 0, 12, 0, 12, 0, 12, 0, 12, 0, 12, 0, 0, 10, 0, 10, 0, 10, 0, 10, 0, 10, 0, 0, 14, 0, 14, 0, 14, 0, 14, 0, 14, 0, 0, 0, 0, 8, 9],
      [9, 9, 2, 2, 2, 2, 2, 2, 2, 2, 2, 2, 2, 2, 2, 2, 2, 2, 2, 2, 2, 2, 2, 2, 2, 2, 2, 2, 2, 2, 2, 2, 2, 2, 2, 2, 2, 2, 9, 9],
      [9, 9, 9, 9, 9, 9, 9, 9, 9, 9, 9, 9, 9, 9, 9, 9, 9, 9, 9, 9, 9, 9, 9, 9, 9, 9, 9, 9, 9, 9, 9, 9, 9, 9, 9, 9, 9, 9, 9, 9]
    ]
}