{
  "playerStart": {
    "x": 11,
    "y": 154
  },

  "ballSpeed": {
    "value": 24
  },

  "taggedTiles": [
    {
      "x": 3,
      "y": 20,
      "tag": "A",
      "type": "PlayerSwitch"
    },
    {
      "x": 12,
      "y": 1,
      "tag": "A",
      "type": "BallGenerator"
    },
    {
      "x": 36,
      "y": 18,
      "tag": "A",
      "type": "BallGenerator"
    },
    {
      "x": 31,
      "y": 14,
      "tag": "A",
      "type": "Toggle"
    },
    {
      "x": 32,
      "y": 14,
      "tag": "A",
      "type": "Toggle"
    },
    {
      "x": 33,
      "y": 14,
      "tag": "A",
      "type": "Toggle"
    },
    {
      "x": 34,
      "y": 14,
      "tag": "A",
      "type": "Toggle"
    },
    {
      "x": 22,
      "y": 16,
      "tag": "A",
      "type": "Toggle"
    },
    {
      "x": 23,
      "y": 16,
      "tag": "A",
      "type": "Toggle"
    },
    {
      "x": 24,
      "y": 16,
      "tag": "A",
      "type": "Toggle"
    },
    {
      "x": 25,
      "y": 16,
      "tag": "A",
      "type": "Toggle"
    },
    {
      "x": 32,
      "y": 6,
      "tag": "A",
      "type": "Toggle"
    },
    {
      "x": 33,
      "y": 6,
      "tag": "A",
      "type": "Toggle"
    },
    {
      "x": 34,
      "y": 6,
      "tag": "A",
      "type": "Toggle"
    },
    {
      "x": 35,
      "y": 6,
      "tag": "A",
      "type": "Toggle"
    },
    {
      "x": 7,
      "y": 20,
      "tag": "B",
      "type": "PlayerSwitch"
    },
    {
      "x": 16,
      "y": 3,
      "tag": "B",
      "type": "Toggle"
    },
    {
      "x": 16,
      "y": 4,
      "tag": "B",
      "type": "Toggle"
    },
    {
      "x": 16,
      "y": 5,
      "tag": "B",
      "type": "Toggle"
    },
    {
      "x": 16,
      "y": 6,
      "tag": "B",
      "type": "Toggle"
    },
    {
      "x": 16,
      "y": 15,
      "tag": "B",
      "type": "Toggle"
    },
    {
      "x": 16,
      "y": 16,
      "tag": "B",
      "type": "Toggle"
    },
    {
      "x": 16,
      "y": 17,
      "tag": "B",
      "type": "Toggle"
    },
    {
      "x": 28,
      "y": 17,
      "tag": "B",
      "type": "Toggle"
    },
    {
      "x": 28,
      "y": 18,
      "tag": "B",
      "type": "Toggle"
    },
    {
      "x": 28,
      "y": 19,
      "tag": "B",
      "type": "Toggle"
    },
    {
      "x": 28,
      "y": 20,
      "tag": "B",
      "type": "Toggle"
    },
    {
      "x": 12,
      "y": 12,
      "tag": "C",
      "type": "BallSwitch"
    },
    {
      "x": 6,
      "y": 15,
      "tag": "C",
      "type": "Toggle"
    },
    {
      "x": 38,
      "y": 1,
      "tag": "D",
      "type": "BallSwitch"
    },
    {
      "x": 4,
      "y": 6,
      "tag": "D",
      "type": "Toggle"
    }
  ],

  "tiles": [
      [9, 9, 9, 9, 9, 9, 9, 9, 9, 9, 9, 9, 6, 6, 6, 6, 6, 6, 6, 6, 6, 6, 6, 6, 6, 6, 6, 6, 6, 6, 6, 6, 6, 6, 6, 6, 6, 6, 6, 9],
      [9, 9, 9, 9, 9, 9, 9, 9, 9, 9, 9, 4, 37, 0, 0, 0, 0, 0, 0, 0, 0, 0, 0, 0, 0, 0, 0, 0, 0, 0, 0, 0, 0, 0, 0, 0, 0, 0, 10, 8],
      [9, 9, 9, 9, 9, 9, 9, 9, 9, 9, 9, 4, 0, 0, 0, 0, 0, 0, 0, 0, 0, 0, 0, 0, 0, 0, 0, 0, 0, 0, 0, 0, 0, 0, 0, 0, 0, 0, 0, 8],
      [9, 9, 9, 9, 9, 9, 9, 9, 9, 9, 9, 4, 0, 0, 0, 0, 14, 0, 0, 0, 0, 0, 0, 0, 0, 0, 0, 0, 0, 0, 0, 0, 0, 0, 0, 0, 0, 0, 0, 8],
      [9, 9, 9, 9, 9, 9, 9, 9, 9, 9, 9, 4, 0, 0, 0, 0, 14, 0, 0, 0, 0, 0, 0, 0, 0, 0, 0, 0, 0, 0, 0, 0, 0, 0, 0, 0, 0, 0, 0, 8],
      [9, 9, 9, 9, 20, 9, 9, 9, 9, 9, 9, 4, 0, 0, 0, 0, 14, 0, 0, 0, 0, 0, 0, 0, 0, 0, 0, 0, 0, 0, 0, 0, 0, 0, 0, 0, 0, 0, 0, 8],
      [9, 6, 6, 5, 15, 7, 6, 6, 6, 6, 9, 4, 0, 0, 0, 0, 14, 0, 0, 0, 0, 0, 0, 0, 0, 0, 0, 0, 0, 0, 0, 0, 14, 14, 14, 14, 0, 0, 0, 8],
      [4, 0, 0, 0, 0, 0, 0, 0, 0, 0, 8, 4, 0, 0, 0, 0, 0, 0, 0, 0, 0, 0, 0, 0, 0, 0, 0, 0, 0, 0, 0, 0, 0, 0, 0, 0, 0, 0, 0, 8],
      [4, 0, 0, 0, 0, 0, 0, 0, 0, 0, 8, 4, 0, 0, 0, 0, 0, 0, 0, 0, 0, 0, 0, 0, 0, 0, 0, 0, 0, 0, 0, 0, 0, 0, 0, 0, 0, 0, 0, 8],
      [4, 0, 16, 0, 0, 0, 0, 0, 0, 0, 8, 4, 0, 0, 0, 0, 0, 0, 0, 0, 0, 0, 0, 0, 0, 0, 0, 0, 0, 0, 0, 0, 0, 0, 0, 0, 0, 0, 0, 8],
      [9, 2, 2, 2, 2, 3, 0, 0, 0, 0, 8, 9, 2, 2, 2, 2, 2, 2, 2, 2, 2, 2, 2, 2, 2, 2, 2, 2, 2, 2, 2, 2, 2, 2, 2, 2, 2, 2, 2, 9],
      [9, 9, 9, 9, 9, 4, 0, 0, 0, 0, 8, 9, 6, 6, 6, 6, 6, 6, 6, 6, 6, 6, 6, 6, 6, 6, 6, 6, 6, 6, 6, 6, 6, 6, 6, 6, 6, 9, 9, 9],
      [9, 9, 9, 9, 9, 4, 0, 0, 0, 1, 9, 4, 10, 0, 0, 0, 0, 0, 0, 0, 0, 0, 0, 0, 0, 0, 0, 0, 0, 0, 0, 0, 0, 0, 0, 0, 0, 8, 9, 9],
      [9, 9, 9, 9, 9, 4, 0, 0, 0, 7, 9, 4, 0, 0, 0, 0, 0, 0, 0, 0, 0, 0, 0, 0, 0, 0, 0, 0, 0, 0, 0, 0, 0, 0, 0, 0, 0, 8, 9, 9],
      [9, 9, 9, 9, 9, 4, 0, 0, 0, 0, 8, 4, 0, 0, 0, 0, 0, 0, 0, 0, 0, 0, 0, 0, 0, 0, 0, 0, 0, 0, 0, 14, 14, 14, 14, 0, 0, 8, 9, 9],
      [9, 9, 9, 9, 9, 17, 15, 0, 0, 0, 8, 4, 0, 0, 0, 0, 14, 0, 0, 0, 0, 0, 0, 0, 0, 0, 0, 0, 0, 0, 0, 0, 0, 0, 0, 0, 0, 8, 9, 9],
      [9, 6, 6, 6, 6, 5, 0, 0, 0, 0, 8, 4, 0, 0, 0, 0, 14, 0, 0, 0, 0, 0, 15, 15, 15, 15, 0, 0, 0, 0, 0, 0, 0, 0, 0, 0, 0, 8, 9, 9],
      [4, 0, 0, 0, 0, 0, 0, 0, 0, 0, 8, 4, 0, 0, 0, 0, 14, 0, 0, 0, 0, 0, 0, 0, 0, 0, 0, 0, 15, 0, 0, 0, 0, 0, 0, 0, 0, 8, 9, 9],
      [4, 0, 0, 0, 0, 0, 0, 0, 0, 1, 9, 4, 0, 0, 0, 0, 0, 0, 0, 0, 0, 0, 0, 0, 0, 0, 0, 0, 15, 0, 0, 0, 0, 0, 0, 0, 29, 8, 9, 9],
      [4, 0, 0, 0, 0, 0, 0, 0, 0, 7, 9, 4, 0, 0, 0, 0, 0, 0, 0, 0, 0, 0, 0, 0, 0, 0, 0, 0, 15, 0, 0, 0, 0, 0, 0, 1, 2, 9, 9, 9],
      [4, 0, 0, 12, 0, 0, 0, 12, 0, 0, 8, 4, 0, 0, 0, 0, 0, 0, 0, 0, 0, 0, 0, 0, 0, 0, 0, 0, 15, 0, 0, 0, 0, 0, 0, 8, 9, 9, 9, 9],
      [9, 2, 2, 2, 2, 2, 2, 2, 2, 2, 9, 9, 2, 2, 2, 2, 2, 2, 2, 2, 2, 2, 2, 2, 2, 2, 2, 2, 2, 2, 2, 2, 2, 2, 2, 9, 9, 9, 9, 9],
      [9, 9, 9, 9, 9, 9, 9, 9, 9, 9, 9, 9, 9, 9, 9, 9, 9, 9, 9, 9, 9, 9, 9, 9, 9, 9, 9, 9, 9, 9, 9, 9, 9, 9, 9, 9, 9, 9, 9, 9],
      [9, 9, 9, 9, 9, 9, 9, 9, 9, 9, 9, 9, 9, 9, 9, 9, 9, 9, 9, 9, 9, 9, 9, 9, 9, 9, 9, 9, 9, 9, 9, 9, 9, 9, 9, 9, 9, 9, 9, 9]
    ]
}