{
  "playerStart": {
    "x": 18,
    "y": 161
  },

  "ballSpeed": {
    "value": 48
  },

  "taggedTiles": [
    {
      "x": 5,
      "y": 21,
      "tag": "A",
      "type": "PlayerSwitch"
    },
    {
      "x": 6,
      "y": 5,
      "tag": "A",
      "type": "Toggle"
    },
    {
      "x": 5,
      "y": 6,
      "tag": "A",
      "type": "Toggle"
    },
    {
      "x": 6,
      "y": 6,
      "tag": "A",
      "type": "Toggle"
    },
    {
      "x": 7,
      "y": 6,
      "tag": "A",
      "type": "Toggle"
    },
    {
      "x": 6,
      "y": 7,
      "tag": "A",
      "type": "Toggle"
    },
    {
      "x": 4,
      "y": 8,
      "tag": "A",
      "type": "BallGenerator"
    },
    {
      "x": 35,
      "y": 2,
      "tag": "B",
      "type": "BallSwitch"
    },
    {
      "x": 35,
      "y": 16,
      "tag": "B",
      "type": "Toggle"
    },
    {
      "x": 35,
      "y": 17,
      "tag": "B",
      "type": "Toggle"
    }
  ],

  "tiles": [
      [9, 6, 6, 6, 6, 6, 6, 6, 6, 6, 6, 6, 6, 6, 6, 6, 6, 6, 6, 6, 6, 6, 6, 6, 6, 6, 6, 6, 6, 6, 6, 6, 6, 6, 6, 6, 6, 6, 6, 9],
      [4, 0, 0, 0, 0, 0, 0, 0, 0, 0, 0, 0, 0, 0, 0, 0, 0, 0, 0, 0, 0, 0, 0, 0, 0, 0, 0, 0, 0, 0, 0, 0, 0, 0, 0, 0, 0, 0, 0, 8],
      [4, 0, 1, 2, 2, 2, 3, 0, 0, 0, 0, 0, 0, 0, 0, 0, 0, 0, 0, 0, 0, 0, 0, 0, 0, 0, 0, 0, 0, 0, 0, 0, 0, 1, 2, 10, 3, 0, 0, 8],
      [4, 0, 8, 9, 6, 9, 4, 0, 0, 0, 0, 0, 0, 0, 0, 0, 0, 0, 0, 0, 0, 0, 0, 0, 0, 0, 0, 0, 0, 0, 0, 0, 0, 8, 9, 6, 5, 0, 0, 8],
      [4, 0, 8, 4, 0, 8, 4, 0, 0, 0, 0, 0, 0, 0, 0, 0, 0, 0, 0, 0, 0, 0, 0, 0, 0, 0, 0, 0, 1, 2, 2, 3, 0, 8, 4, 0, 0, 0, 0, 8],
      [4, 0, 8, 9, 2, 9, 14, 0, 0, 0, 0, 0, 0, 0, 0, 0, 0, 0, 0, 0, 0, 0, 1, 2, 2, 2, 3, 0, 8, 9, 6, 5, 0, 8, 9, 2, 3, 0, 0, 8],
      [4, 0, 8, 9, 6, 14, 14, 14, 0, 0, 0, 0, 0, 0, 0, 1, 3, 0, 1, 3, 0, 0, 8, 9, 6, 9, 4, 0, 8, 4, 0, 0, 0, 8, 9, 6, 5, 0, 0, 8],
      [4, 0, 8, 4, 0, 0, 14, 4, 0, 0, 0, 0, 0, 0, 0, 8, 4, 0, 8, 4, 0, 0, 8, 4, 0, 8, 4, 0, 8, 9, 2, 3, 0, 8, 4, 0, 0, 0, 0, 8],
      [4, 0, 8, 4, 25, 0, 8, 4, 0, 0, 0, 0, 0, 0, 0, 8, 4, 0, 8, 4, 0, 0, 8, 4, 0, 8, 4, 0, 7, 6, 6, 5, 0, 8, 9, 2, 3, 0, 0, 8],
      [4, 0, 8, 9, 2, 2, 9, 4, 0, 1, 2, 2, 2, 3, 0, 8, 4, 0, 8, 4, 0, 0, 8, 4, 0, 8, 4, 0, 0, 0, 0, 0, 0, 7, 6, 6, 5, 0, 0, 8],
      [4, 0, 7, 6, 6, 6, 6, 5, 0, 8, 9, 6, 9, 4, 0, 8, 9, 2, 9, 4, 0, 0, 7, 5, 0, 7, 5, 0, 0, 0, 0, 0, 0, 0, 0, 0, 0, 0, 0, 8],
      [4, 0, 0, 0, 0, 0, 0, 0, 0, 8, 4, 0, 8, 4, 0, 7, 6, 6, 6, 5, 0, 0, 0, 0, 0, 0, 0, 0, 0, 0, 0, 0, 0, 0, 0, 0, 0, 0, 0, 8],
      [4, 0, 0, 0, 0, 0, 0, 0, 0, 8, 9, 2, 9, 4, 0, 0, 0, 0, 0, 0, 0, 0, 0, 0, 0, 0, 0, 0, 0, 0, 0, 0, 0, 0, 0, 0, 0, 0, 0, 8],
      [4, 0, 0, 0, 0, 0, 0, 0, 0, 7, 6, 6, 6, 5, 0, 0, 0, 0, 0, 0, 0, 0, 0, 0, 0, 0, 0, 0, 0, 0, 0, 0, 0, 0, 0, 0, 0, 0, 0, 8],
      [9, 2, 2, 2, 2, 2, 2, 2, 2, 2, 2, 2, 2, 2, 2, 2, 2, 2, 2, 2, 2, 2, 2, 2, 2, 2, 2, 2, 2, 2, 2, 2, 2, 2, 2, 2, 2, 2, 2, 9],
      [9, 6, 6, 6, 6, 6, 6, 6, 6, 6, 6, 6, 6, 6, 6, 6, 6, 6, 6, 6, 6, 6, 6, 6, 6, 6, 6, 6, 6, 6, 6, 6, 6, 6, 6, 6, 6, 6, 6, 9],
      [4, 0, 0, 0, 0, 0, 0, 0, 0, 0, 0, 0, 0, 0, 0, 0, 0, 0, 0, 0, 0, 0, 0, 0, 0, 0, 0, 0, 0, 0, 0, 0, 0, 0, 0, 14, 0, 0, 0, 8],
      [4, 0, 0, 0, 0, 0, 0, 0, 0, 0, 0, 0, 0, 0, 0, 0, 0, 0, 0, 0, 0, 0, 0, 0, 0, 0, 0, 0, 0, 0, 0, 0, 0, 0, 0, 14, 0, 16, 0, 8],
      [4, 0, 0, 0, 0, 0, 0, 0, 0, 0, 0, 0, 0, 0, 0, 0, 0, 0, 0, 0, 0, 0, 0, 0, 0, 0, 0, 0, 0, 0, 0, 0, 0, 0, 0, 1, 2, 2, 2, 9],
      [4, 0, 0, 0, 0, 0, 0, 0, 0, 0, 1, 2, 3, 0, 0, 1, 2, 3, 0, 0, 0, 0, 0, 0, 0, 0, 0, 0, 1, 2, 2, 2, 3, 0, 0, 8, 9, 9, 9, 9],
      [4, 0, 0, 0, 0, 0, 0, 0, 0, 1, 9, 9, 4, 0, 0, 7, 6, 5, 0, 0, 0, 0, 1, 2, 3, 0, 0, 0, 7, 6, 6, 6, 5, 0, 0, 8, 9, 9, 9, 9],
      [4, 0, 0, 0, 0, 12, 0, 0, 1, 9, 9, 9, 4, 0, 0, 0, 0, 0, 0, 0, 0, 0, 7, 6, 5, 0, 0, 0, 0, 0, 0, 0, 0, 0, 0, 8, 9, 9, 9, 9],
      [9, 2, 2, 2, 2, 2, 2, 2, 9, 9, 9, 9, 4, 0, 0, 0, 0, 0, 0, 0, 0, 0, 0, 0, 0, 0, 0, 0, 0, 0, 0, 0, 0, 0, 0, 8, 9, 9, 9, 9],
      [9, 9, 9, 9, 9, 9, 9, 9, 9, 9, 9, 9, 4, 0, 0, 0, 0, 0, 0, 0, 0, 0, 0, 0, 0, 0, 0, 0, 0, 0, 0, 0, 0, 0, 0, 8, 9, 9, 9, 9]
    ]
}